1111111111111111111111111111111111
1E0001000000000C00000C000000000001
1FF0010100100000101001000000010101
10100100101010100010010O0000010101
100000000C00C0000000000000100000C1
10100100F0101110001001000000010101
1110011001100110001101000000010101
100O000000000000000000000000000001
100000000000F000000000010000000O01
1000000000000000000000010000000001
1FF00FF00FF00FF000000FC10000000F01
1110011001100110011001F10000F00101
1000000000000000011111110000100001
10000F0000000000011000000000000001
1000010O00000000011001111111111111
100C00000000000C0110000000000000P1
1111111111111111111111111111111111