1111111111111111111111111111111111
1E0001000000000C00000C000000000001
10F0010100100000101001000000010101
10100100101010100010010O0000010101
100000000C00C0000000000000000000C1
10100100F0101010001001000000010101
1010010010101010001001000000010101
1000000000000000P00000000F00000001
100000000000F000000000000000000001
1000000000000000000000000000000001
100000000000000C000000000000000001
1010010010101010001001000000010101
1000000000000000001100000F00000001
100000000000F000000000000000000001
1000000000000000000000000000000001
1000O0000000000C000000000000000001
111111111111111111111111F111111111