1111111111111111111111111111111111
1E1000000000000C00000C000000000001
1000010100100000101001000000010101
111001001110101000100100O000010101
1P0000000C101000000000000000000101
1111111111111111111111111111111111