1111111111111111111111111111111111
1E1000000000000C00000C000O00000001
1000010100100000101001000000010101
1110010011101010001001000000010101
1P0000000C101000000000000000000101
1111111111111111111111111111111111