1111111111111
1001PE00000O1
100C0111F1001
100C110C00001
11F1111111F11