1111111111111
1001PE00000O1
100C011111001
100C110C00001
1111111111111